Region;year;quarter;total;women;men;ineligible;not_previously_employed;previously_employed;unemployed_for_over_ a_year;rural_residents;city_residents
Dolnoslaskie;2025;1;59416;29965;29451;4839;54577;49951;21106;22222;37194
Kujawsko-pomorskie;2025;1;57163;31775;25388;6001;51162;47419;23007;27590;29573
Lubelskie;2025;1;57353;27404;29949;9777;47576;50495;23601;31393;25960
Lubuskie;2025;1;17349;8932;8417;1647;15702;14383;4448;6955;10394
Lodzkie;2025;1;57109;27937;29172;4867;52242;48614;22085;19115;37994
Malopolskie;2025;1;64294;33286;31008;8245;56049;54833;22245;33799;30495
Mazowieckie;2025;1;113866;54313;59553;15691;98175;96248;45941;51093;62773
Opolskie;2025;1;20813;10884;9929;1798;19015;17748;7910;9262;11551
Podkarpackie;2025;1;69031;34451;34580;8648;60383;57949;30623;43323;25708
Podlaskie;2025;1;31185;13432;17753;4588;26597;27382;13778;11823;19362
Pomorskie;2025;1;45965;26099;19866;4365;41600;38310;15016;19861;26104
Slaskie;2025;1;68730;35373;33357;7277;61453;57919;19271;16516;52214
Swietokrzyskie;2025;1;33316;15973;17343;4401;28915;28293;12565;17507;15809
Warminsko-mazurskie;2025;1;41016;20934;20082;4143;36873;33300;13938;21183;19833
Wielkopolskie;2025;1;51229;28775;22454;4647;46582;42397;14439;23942;27287
Zachodniopomorskie;2025;1;42038;22003;20035;4561;37477;35727;15397;17274;24764
Dolnoslaskie;2024;4;55474;28265;27209;46513;4752;50722;20513;20947;34527
Kujawsko-pomorskie;2024;4;55333;31116;24217;46094;6278;49055;22410;27124;28209
Lubelskie;2024;4;55774;27135;28639;49263;10102;45672;23382;30807;24967
Lubuskie;2024;4;15926;8480;7446;13204;1576;14350;4294;6629;9297
Lodzkie;2024;4;53336;26494;26842;45350;4910;48426;21280;17914;35422
Malopolskie;2024;4;60654;31958;28696;51631;8184;52470;21433;32193;28461
Mazowieckie;2024;4;109020;52680;56340;91838;15851;93169;44914;49366;59654
Opolskie;2024;4;19997;10656;9341;16964;1833;18164;7907;8944;11053
Podkarpackie;2024;4;67336;33994;33342;56672;8962;58374;30156;42647;24689
Podlaskie;2024;4;30354;13186;17168;26544;4663;25691;13616;11588;18766
Pomorskie;2024;4;42924;24919;18005;35908;4318;38606;14596;18972;23952
Slaskie;2024;4;62583;32689;29894;52794;7011;55572;18856;15297;47286
Swietokrzyskie;2024;4;32289;15902;16387;27378;4524;27765;12511;17238;15051
Warminsko-mazurskie;2024;4;38879;20383;18496;31545;4238;34641;13481;20424;18455
Wielkopolskie;2024;4;46625;26732;19893;38619;4671;41954;13879;22096;24529
Zachodniopomorskie;2024;4;39675;21217;18458;33723;4425;35250;14824;16762;22913
Dolnoslaskie;2024;3;54798;28381;26417;4928;49870;46074;20309;20581;34217
Kujawsko-pomorskie;2024;3;52645;29992;22653;6302;46343;43810;21639;25763;26882
Lubelskie;2024;3;53628;26688;26940;10195;43433;47786;23161;29145;24483
Lubuskie;2024;3;15385;8298;7087;1633;13752;12830;4231;6279;9106
Lodzkie;2024;3;53165;26615;26550;5137;48028;45645;21109;17586;35579
Malopolskie;2024;3;59849;32199;27650;8719;51130;51541;21149;31646;28203
Mazowieckie;2024;3;109607;53993;55614;16409;93198;92797;44783;49353;60254
Opolskie;2024;3;19368;10558;8810;1911;17457;16568;7789;8678;10690
Podkarpackie;2024;3;64702;33226;31476;9083;55619;54914;29643;40558;24144
Podlaskie;2024;3;29919;13229;16690;4804;25115;26238;13480;11349;18570
Pomorskie;2024;3;41840;24648;17192;4396;37444;35009;14581;18223;23617
Slaskie;2024;3;62429;33248;29181;7194;55235;52976;19008;14867;47562
Swietokrzyskie;2024;3;31421;15860;15561;4745;26676;26741;12305;16515;14906
Warminsko-mazurskie;2024;3;36281;19289;16992;4202;32079;29672;13056;18744;17537
Wielkopolskie;2024;3;46221;26615;19606;4898;41323;38454;13782;21754;24467
Zachodniopomorskie;2024;3;38326;20745;17581;4557;33769;32748;14670;15757;22569
Dolnoslaskie;2024;2;53915;27769;26146;4548;49367;44959;20223;20226;33689
Kujawsko-pomorskie;2024;2;52581;30011;22570;6041;46540;43643;21637;25678;26903
Lubelskie;2024;2;54236;26759;27477;9825;44411;48033;23571;29325;24911
Lubuskie;2024;2;15226;8145;7081;1496;13730;12583;4235;6264;8962
Lodzkie;2024;2;52564;26380;26184;4737;47827;45030;21043;17301;35263
Malopolskie;2024;2;59306;31810;27496;8209;51097;50522;21354;30957;28349
Mazowieckie;2024;2;108502;53022;55480;15770;92732;91757;44701;48554;59948
Opolskie;2024;2;19058;10346;8712;1751;17307;16308;7841;8561;10497
Podkarpackie;2024;2;63814;32664;31150;8258;55556;53868;29692;40012;23802
Podlaskie;2024;2;29498;12916;16582;4563;24935;25674;13426;11150;18348
Pomorskie;2024;2;41535;24459;17076;4094;37441;34313;14700;18066;23469
Slaskie;2024;2;61611;32434;29177;6666;54945;52416;19291;14710;46901
Swietokrzyskie;2024;2;30958;15367;15591;4456;26502;26038;12310;16338;14620
Warminsko-mazurskie;2024;2;35683;18727;16956;3783;31900;28943;13016;18358;17325
Wielkopolskie;2024;2;45632;26310;19322;4465;41167;37642;13762;21481;24151
Zachodniopomorskie;2024;2;38042;20507;17535;4332;33710;32467;14654;15630;22412
Dolnoslaskie;2024;1;57035;29198;27837;4668;52367;48166;20719;21292;35743
Kujawsko-pomorskie;2024;1;56239;31781;24458;6102;50137;46706;22117;27512;28727
Lubelskie;2024;1;58369;28445;29924;10455;47914;51720;24772;31814;26555
Lubuskie;2024;1;16551;8806;7745;1645;14906;13800;4324;6870;9681
Lodzkie;2024;1;55835;27822;28013;4915;50920;48139;21426;18834;37001
Malopolskie;2024;1;64470;34162;30308;8722;55748;55347;22404;34091;30379
Mazowieckie;2024;1;114766;55772;58994;16333;98433;97612;46240;51743;63023
Opolskie;2024;1;20373;10980;9393;1845;18528;17581;8085;9228;11145
Podkarpackie;2024;1;68399;34582;33817;8752;59647;57917;30449;43193;25206
Podlaskie;2024;1;31361;13643;17718;4714;26647;27254;13702;11819;19542
Pomorskie;2024;1;45792;26863;18929;4445;41347;38337;15173;20314;25478
Slaskie;2024;1;67030;35379;31651;7191;59839;57735;20045;16066;50964
Swietokrzyskie;2024;1;33589;16598;16991;4609;28980;28113;12897;17849;15740
Warminsko-mazurskie;2024;1;40622;21303;19319;4137;36485;32963;13737;21199;19423
Wielkopolskie;2024;1;50234;28737;21497;4721;45513;41787;14237;23823;26411
Zachodniopomorskie;2024;1;41512;22165;19347;4637;36875;35506;15177;17054;24458
Dolnoslaskie;2023;4;52970;27452;25518;44815;4599;48371;20237;20396;32574
Kujawsko-pomorskie;2023;4;54376;31290;23086;45121;6289;48087;21574;26853;27523
Lubelskie;2023;4;57386;28316;29070;50721;10812;46574;24734;31809;25577
Lubuskie;2023;4;15379;8371;7008;12731;1590;13789;4199;6494;8885
Lodzkie;2023;4;53158;26770;26388;45878;5106;48052;20850;18450;34708
Malopolskie;2023;4;60947;33010;27937;52293;8894;52053;21784;32800;28147
Mazowieckie;2023;4;110526;54274;56252;93751;16469;94057;45695;50984;59542
Opolskie;2023;4;20309;11110;9199;17562;1977;18332;7929;9177;11132
Podkarpackie;2023;4;67653;34679;32974;57251;9166;58487;30235;43028;24625
Podlaskie;2023;4;30992;13788;17204;26827;4827;26165;13480;11963;19029
Pomorskie;2023;4;42807;25554;17253;35746;4502;38305;14598;19344;23463
Slaskie;2023;4;62445;33577;28868;53603;7153;55292;19475;15165;47280
Swietokrzyskie;2023;4;33724;17048;16676;28041;4916;28808;12783;18200;15524
Warminsko-mazurskie;2023;4;39317;20986;18331;31781;4328;34989;13497;20683;18634
Wielkopolskie;2023;4;46531;27191;19340;38608;4707;41824;13777;22240;24291
Zachodniopomorskie;2023;4;39709;21520;18189;33780;4594;35115;14891;16666;23043
Dolnoslaskie;2023;3;52273;27592;24681;4855;47418;44402;20147;20010;32263
Kujawsko-pomorskie;2023;3;52427;30749;21678;6551;45876;43719;21165;25782;26645
Lubelskie;2023;3;55214;27986;27228;10765;44449;49331;24807;30037;25177
Lubuskie;2023;3;15358;8543;6815;1757;13601;12871;4237;6380;8978
Lodzkie;2023;3;53555;27178;26377;5359;48196;46351;21212;18230;35325
Malopolskie;2023;3;60427;33577;26850;9276;51151;52521;22658;32193;28234
Mazowieckie;2023;3;111381;55872;55509;17349;94032;95052;45930;50682;60699
Opolskie;2023;3;19623;10923;8700;1969;17654;17011;7937;8815;10808
Podkarpackie;2023;3;64746;34036;30710;9309;55437;55279;30018;40511;24235
Podlaskie;2023;3;30171;13704;16467;4904;25267;26409;13372;11554;18617
Pomorskie;2023;3;42151;25359;16792;4678;37473;35606;14572;18958;23193
Slaskie;2023;3;63497;34857;28640;7645;55852;54824;19793;15371;48126
Swietokrzyskie;2023;3;32730;16804;15926;5013;27717;27653;12817;17455;15275
Warminsko-mazurskie;2023;3;37462;20257;17205;4377;33085;30515;13176;19428;18034
Wielkopolskie;2023;3;46799;27601;19198;4955;41844;38801;13395;22220;24579
Zachodniopomorskie;2023;3;38173;21039;17134;4610;33563;32534;14740;15671;22502
Dolnoslaskie;2023;2;52565;27625;24940;44191;4603;47962;20350;19965;32600
Kujawsko-pomorskie;2023;2;53844;31479;22365;44432;6349;47495;21694;26477;27367
Lubelskie;2023;2;56552;28418;28134;50504;10464;46088;25463;30585;25967
Lubuskie;2023;2;15000;8350;6650;12464;1643;13357;4264;6283;8717
Lodzkie;2023;2;55091;28057;27034;47193;5336;49755;22044;18583;36508
Malopolskie;2023;2;61470;34098;27372;53202;9034;52436;23585;32279;29191
Mazowieckie;2023;2;110693;55254;55439;93897;16538;94155;46756;50046;60647
Opolskie;2023;2;20867;11726;9141;18064;2023;18844;8284;9385;11482
Podkarpackie;2023;2;65064;34104;30960;55542;8745;56319;30578;40617;24447
Podlaskie;2023;2;30356;13741;16615;26420;4751;25605;13525;11602;18754
Pomorskie;2023;2;41091;24631;16460;34369;4269;36822;14514;18329;22762
Slaskie;2023;2;63906;34769;29137;54353;7098;56808;20470;15409;48497
Swietokrzyskie;2023;2;33450;17097;16353;28353;4855;28595;13423;17943;15507
Warminsko-mazurskie;2023;2;38907;21089;17818;31372;4339;34568;13723;20118;18789
Wielkopolskie;2023;2;46464;27285;19179;37832;4515;41949;13268;21987;24477
Zachodniopomorskie;2023;2;38200;20968;17232;32460;4377;33823;15204;15831;22369
Dolnoslaskie;2023;1;56607;29632;26975;47875;4944;51663;21008;21556;35051
Kujawsko-pomorskie;2023;1;58087;33721;24366;48428;6437;51650;22967;28533;29554
Lubelskie;2023;1;62094;30994;31100;55550;11341;50753;26855;33733;28361
Lubuskie;2023;1;16758;9165;7593;14037;1759;14999;4530;7146;9612
Lodzkie;2023;1;57352;28955;28397;49392;5436;51916;23011;19618;37734
Malopolskie;2023;1;67769;37084;30685;58784;9987;57782;24747;35617;32152
Mazowieckie;2023;1;119319;59301;60018;101843;17725;101594;49517;53717;65602
Opolskie;2023;1;21675;12133;9542;18879;2061;19614;8542;9728;11947
Podkarpackie;2023;1;70333;36571;33762;59977;9340;60993;32310;44445;25888
Podlaskie;2023;1;32104;14443;17661;27964;4935;27169;13957;12152;19952
Pomorskie;2023;1;45573;27196;18377;38394;4729;40844;14950;20371;25202
Slaskie;2023;1;68678;37141;31537;58720;7515;61163;21739;16597;52081
Swietokrzyskie;2023;1;35260;17787;17473;30061;4816;30444;13809;19007;16253
Warminsko-mazurskie;2023;1;43332;23323;20009;34895;4641;38691;14320;22678;20654
Wielkopolskie;2023;1;50046;28933;21113;41067;4818;45228;13555;23621;26425
Zachodniopomorskie;2023;1;41881;23056;18825;35559;4691;37190;16229;17577;24304
Dolnoslaskie;2022;4;54000;28400;25600;45900;5000;48900;21100;20800;33200
Kujawsko-pomorskie;2022;4;56500;33300;23200;47400;6700;49800;23800;27800;28700
Lubelskie;2022;4;61300;31000;30300;55300;11800;49400;27400;33100;28200
Lubuskie;2022;4;15700;8700;7000;13300;1700;14000;4700;6900;8800
Lodzkie;2022;4;54400;27800;26600;47200;5500;48900;23400;18700;35700
Malopolskie;2022;4;64400;35300;29100;56300;9500;54900;25500;33900;30500
Mazowieckie;2022;4;116500;59000;57500;100200;18300;98200;51300;53000;63500
Opolskie;2022;4;20500;11600;8900;18000;2100;18400;8500;9200;11300
Podkarpackie;2022;4;69000;36100;32900;59200;9700;59400;33000;43800;25200
Podlaskie;2022;4;31200;14200;17000;27100;5100;26100;14000;12100;19100
Pomorskie;2022;4;42400;25800;16600;36100;4700;37700;15000;19400;23000
Slaskie;2022;4;64900;35600;29300;55800;7600;57300;22600;15700;49200
Swietokrzyskie;2022;4;34000;17400;16600;29200;5000;29100;14000;18500;15500
Warminsko-mazurskie;2022;4;41100;22500;18600;33200;4700;36300;14200;21600;19500
Wielkopolskie;2022;4;46300;27100;19200;38400;4700;41500;13600;22100;24200
Zachodniopomorskie;2022;4;40100;22600;17500;34300;4700;35500;16600;17200;22900
Dolnoslaskie;2022;3;53600;29000;24600;45800;5400;48200;21800;20500;33100
Kujawsko-pomorskie;2022;3;54400;32700;21700;46300;6900;47500;24700;26400;28000
Lubelskie;2022;3;59000;30400;28600;53600;11800;47200;28200;31400;27600
Lubuskie;2022;3;15200;8700;6500;12900;1800;13400;5000;6500;8700
Lodzkie;2022;3;56000;28800;27200;49000;5900;50100;26000;18300;37700
Malopolskie;2022;3;63900;35900;28000;56500;9800;54100;27200;32700;31200
Mazowieckie;2022;3;118300;61000;57300;102600;19400;98900;54200;52600;65700
Opolskie;2022;3;20300;11700;8600;17900;2200;18100;8800;9100;11200
Podkarpackie;2022;3;67800;36500;31300;58600;10100;57600;34200;42400;25400
Podlaskie;2022;3;30800;14400;16400;27200;5200;25600;14500;11800;19000
Pomorskie;2022;3;41200;25500;15700;35400;4700;36600;15800;18600;22600
Slaskie;2022;3;66800;37400;29400;57900;8200;58500;24500;15600;51200
Swietokrzyskie;2022;3;33100;17200;15900;28500;5100;28000;14400;17800;15300
Warminsko-mazurskie;2022;3;38200;21500;16700;31400;4700;33400;14300;19700;18500
Wielkopolskie;2022;3;44700;26700;18000;37500;4800;39800;14000;21100;23600
Zachodniopomorskie;2022;3;38500;22000;16500;33300;4700;33800;17200;16200;22300
Dolnoslaskie;2022;2;54037;29222;24815;46109;5239;48798;23604;20627;33410
Kujawsko-pomorskie;2022;2;55447;33405;22042;47178;6822;48625;26842;26570;28877
Lubelskie;2022;2;61342;31326;30016;55426;11852;49490;30308;32341;29001
Lubuskie;2022;2;15789;9011;6778;13262;1798;13991;5759;6704;9085
Lodzkie;2022;2;58230;29784;28446;51068;5723;52507;28527;18224;40006
Malopolskie;2022;2;63943;35943;28000;56130;9294;54649;29719;32517;31426
Mazowieckie;2022;2;121733;62925;58808;104930;19091;102642;58945;53245;68488
Opolskie;2022;2;20185;11582;8603;17677;2098;18087;9324;8982;11203
Podkarpackie;2022;2;69016;37256;31760;59312;9758;59258;36269;42985;26031
Podlaskie;2022;2;31165;14439;16726;27512;5076;26089;15674;11580;19585
Pomorskie;2022;2;41586;25947;15639;35284;4748;36838;17499;18313;23273
Slaskie;2022;2;70215;39202;31013;60542;8120;62095;27977;16393;53822
Swietokrzyskie;2022;2;33888;17558;16330;28560;4827;29061;15542;18099;15789
Warminsko-mazurskie;2022;2;37657;21243;16414;30719;4469;33188;15060;19362;18295
Wielkopolskie;2022;2;44161;26670;17491;36888;4535;39626;15518;20355;23806
Zachodniopomorskie;2022;2;39650;22650;17000;34132;4919;34731;18603;16623;23027
Dolnoslaskie;2022;1;59500;31800;27700;5600;54000;51000;26100;22700;36800
Kujawsko-pomorskie;2022;1;61600;36500;25100;7300;54400;52800;30100;29900;31700
Lubelskie;2022;1;67200;33700;33500;12600;54500;60500;32700;36000;31200
Lubuskie;2022;1;17900;10200;7700;2000;15900;15200;6700;7500;10400
Lodzkie;2022;1;62300;31400;30900;5900;56300;55000;30500;19700;42600
Malopolskie;2022;1;70500;38500;32000;9400;61100;62100;32700;36400;34100
Mazowieckie;2022;1;130400;66000;64400;18700;111600;112600;64400;58100;72300
Opolskie;2022;1;21800;12400;9400;2200;19600;19200;9900;9800;12000
Podkarpackie;2022;1;76700;40700;36000;10800;65900;66100;39500;48000;28700
Podlaskie;2022;1;33600;15500;18100;5400;28300;30000;17000;12500;21100
Pomorskie;2022;1;47000;28600;18400;4900;42100;40400;20300;20900;26100
Slaskie;2022;1;77800;42900;34900;9100;68700;67800;31700;18500;59300
Swietokrzyskie;2022;1;38000;19500;18500;5300;32700;32200;17400;20200;17800
Warminsko-mazurskie;2022;1;43200;24100;19100;5000;38200;35600;16800;22500;20700
Wielkopolskie;2022;1;50400;29900;20500;5100;45300;42700;18100;23200;27200
Zachodniopomorskie;2022;1;44100;24800;19300;5300;38900;38200;20300;18700;25400
Dolnoslaskie;2021;4;58700;31100;27600;50400;4900;53900;26900;22600;36100
Kujawsko-pomorskie;2021;4;61900;36600;25300;52900;7000;54900;31700;30000;31900
Lubelskie;2021;4;66200;33300;32900;59900;12700;53600;33300;36000;30200
Lubuskie;2021;4;18200;10300;7900;15400;1900;16300;7100;7800;10400
Lodzkie;2021;4;60900;30600;30300;53600;5700;55200;30900;19600;41300
Malopolskie;2021;4;69900;38100;31800;61700;9200;60700;33500;36100;33800
Mazowieckie;2021;4;129200;65300;63900;111600;18400;110900;65800;57900;71300
Opolskie;2021;4;21500;12200;9300;19000;2000;19500;10200;9800;11700
Podkarpackie;2021;4;77300;41100;36200;66800;11100;66200;40700;48700;28600
Podlaskie;2021;4;33400;15300;18100;29800;5200;28200;17400;12600;20800
Pomorskie;2021;4;47700;28600;19100;41000;4900;42800;21700;21200;26500
Slaskie;2021;4;76300;41800;34500;66500;8200;68100;33400;18300;58000
Swietokrzyskie;2021;4;38000;19700;18300;32400;5600;32500;18100;20800;17200
Warminsko-mazurskie;2021;4;42600;24000;18600;34900;4900;37700;17100;22400;20200
Wielkopolskie;2021;4;49900;29600;20300;42300;4900;44900;19000;23000;26900
Zachodniopomorskie;2021;4;43400;24300;19100;37700;4900;38600;20700;18600;24800
Dolnoslaskie;2021;3;62200;33400;28800;53700;5500;56700;28300;23300;38900
Kujawsko-pomorskie;2021;3;63700;38000;25700;54800;7700;56000;33500;30400;33300
Lubelskie;2021;3;67100;34400;32700;61000;13400;53700;34800;35800;31300
Lubuskie;2021;3;19200;11100;8100;16300;2100;17100;7700;8100;11100
Lodzkie;2021;3;63800;32500;31300;56200;6100;57700;31900;20100;43700
Malopolskie;2021;3;73800;40600;33200;65400;10100;63700;34900;37600;36200
Mazowieckie;2021;3;134900;68900;66000;116900;19800;115100;68600;59700;75200
Opolskie;2021;3;22000;12500;9500;19500;2200;19800;10600;9800;12200
Podkarpackie;2021;3;78300;42300;36000;68300;11900;66400;42200;48500;29800
Podlaskie;2021;3;34500;16100;18400;30900;5500;29000;18000;12700;21800
Pomorskie;2021;3;51400;30700;20700;44400;5400;46000;23100;22100;29300
Slaskie;2021;3;83000;45800;37200;72800;9400;73600;35800;19400;63600
Swietokrzyskie;2021;3;39200;20500;18700;33700;6000;33200;19200;21300;17900
Warminsko-mazurskie;2021;3;43000;24400;18600;35700;5300;37700;18300;22200;20800
Wielkopolskie;2021;3;54000;31900;22100;46200;5700;48300;21500;24500;29500
Zachodniopomorskie;2021;3;44500;24900;19600;38900;5300;39200;21700;18500;26000
Dolnoslaskie;2021;2;66714;35518;31196;56817;5582;61132;28738;24626;42088
Kujawsko-pomorskie;2021;2;68415;40247;28168;58183;7936;60479;35067;32171;36244
Lubelskie;2021;2;71514;36159;35355;64548;13776;57738;36534;38193;33321
Lubuskie;2021;2;21626;12370;9256;18205;2295;19331;8237;9010;12616
Lodzkie;2021;2;66819;33952;32867;58135;6126;60693;32238;21017;45802
Malopolskie;2021;2;78455;42715;35740;68310;10076;68379;35552;39813;38642
Mazowieckie;2021;2;141367;71540;69827;120819;20007;121360;69812;62081;79286
Opolskie;2021;2;23165;13017;10148;20464;2280;20885;10822;10232;12933
Podkarpackie;2021;2;80944;43242;37702;69770;11657;69287;43071;49815;31129
Podlaskie;2021;2;35977;16683;19294;31722;5596;30381;18336;13058;22919
Pomorskie;2021;2;54730;32314;22416;46906;5565;49165;23070;22756;31974
Slaskie;2021;2;89086;48706;40380;77402;9777;79309;36394;20668;68418
Swietokrzyskie;2021;2;41832;21555;20277;35868;6149;35683;20270;22656;19176
Warminsko-mazurskie;2021;2;46300;25821;20479;38252;5434;40866;19853;23703;22597
Wielkopolskie;2021;2;57736;33777;23959;48720;5841;51895;22282;25818;31918
Zachodniopomorskie;2021;2;48714;26795;21919;42180;5723;42991;22371;19920;28794
Dolnoslaskie;2021;1;71700;38000;33700;60300;5800;65900;28500;26500;45200
Kujawsko-pomorskie;2021;1;75100;43500;31600;63300;8200;66900;35300;35600;39500
Lubelskie;2021;1;77500;38600;38900;69300;14500;63000;37300;41800;35700
Lubuskie;2021;1;23900;13400;10500;19900;2400;21400;8100;10100;13800
Lodzkie;2021;1;70600;35700;34900;61300;6400;64200;31500;22800;47800
Malopolskie;2021;1;86100;46200;39900;74200;10700;75400;34200;44400;41700
Mazowieckie;2021;1;149900;75300;74600;127000;20600;129300;69400;66600;83300
Opolskie;2021;1;25300;14000;11300;22300;2500;22800;10800;11200;14100
Podkarpackie;2021;1;88400;46400;42000;75400;12500;75900;43400;54800;33600
Podlaskie;2021;1;39000;17900;21100;34000;5800;33100;18300;14100;24900
Pomorskie;2021;1;59400;34700;24700;50300;5900;53500;22300;24900;34500
Slaskie;2021;1;95100;51800;43300;82200;10200;84800;34700;22100;73000
Swietokrzyskie;2021;1;45600;23100;22500;39000;6500;39100;21000;24800;20800
Warminsko-mazurskie;2021;1;53500;29100;24400;43900;6000;47500;20900;27500;26000
Wielkopolskie;2021;1;63500;36500;27000;53100;6100;57400;21900;28600;34900
Zachodniopomorskie;2021;1;53800;29300;24500;46000;6100;47700;22000;22300;31500
Dolnoslaskie;2020;4;68800;36700;32100;56600;5700;63100;25500;25900;42900
Kujawsko-pomorskie;2020;4;73500;42900;30600;61000;8300;65200;32200;34900;38600
Lubelskie;2020;4;76500;38700;37800;67900;14800;61700;35100;41600;34900
Lubuskie;2020;4;23700;13400;10300;19200;2500;21100;7000;10000;13700
Lodzkie;2020;4;67800;34600;33200;57900;6400;61400;28700;22300;45500
Malopolskie;2020;4;83100;45200;37900;70100;10700;72400;30600;43500;39600
Mazowieckie;2020;4;146400;74000;72400;122100;21100;125200;63600;65900;80500
Opolskie;2020;4;25000;13800;11200;21700;2500;22500;9700;11100;13900
Podkarpackie;2020;4;87300;46000;41300;73400;12600;74700;40600;54200;33100
Podlaskie;2020;4;37800;17600;20200;32500;5800;32100;16900;13800;24000
Pomorskie;2020;4;56200;33300;22900;46700;5800;50400;19100;23800;32400
Slaskie;2020;4;91000;49900;41100;76200;9900;81100;29200;21500;69500
Swietokrzyskie;2020;4;44900;23100;21800;38000;6500;38300;19600;24600;20300
Warminsko-mazurskie;2020;4;51500;28400;23100;41600;6000;45500;19200;26400;25100
Wielkopolskie;2020;4;61000;35500;25500;49800;5900;55000;19100;27900;33100
Zachodniopomorskie;2020;4;52000;28500;23500;43900;6000;46000;19500;21900;30100
Dolnoslaskie;2020;3;68796;36626;32170;56264;5843;62953;23571;25714;43082
Kujawsko-pomorskie;2020;3;70907;41624;29283;58422;8248;62659;29388;33479;37428
Lubelskie;2020;3;73807;37862;35945;65428;14342;59465;32750;39520;34287
Lubuskie;2020;3;23138;13180;9958;18570;2606;20532;6258;9584;13554
Lodzkie;2020;3;67301;34653;32648;57195;6361;60940;26695;21926;45375
Malopolskie;2020;3;80298;44271;36027;66982;10329;69969;27458;42366;37932
Mazowieckie;2020;3;145108;73853;71255;120438;21267;123841;58812;64997;80111
Opolskie;2020;3;24759;13868;10891;21219;2539;22220;8760;10946;13813
Podkarpackie;2020;3;85412;45435;39977;71779;12609;72803;37792;52370;33042
Podlaskie;2020;3;36777;17298;19479;31574;5647;31130;15758;13521;23256
Pomorskie;2020;3;53727;32082;21645;44176;5594;48133;16917;23048;30679
Slaskie;2020;3;89087;49025;40062;73647;9539;79548;25678;20913;68174
Swietokrzyskie;2020;3;44892;23072;21820;37960;6636;38256;18218;24511;20381
Warminsko-mazurskie;2020;3;50175;27846;22329;40323;5982;44193;17489;25358;24817
Wielkopolskie;2020;3;60670;35330;25340;49094;5971;54699;16617;27822;32848
Zachodniopomorskie;2020;3;48892;26900;21992;40747;5651;43241;17576;20334;28558
Dolnoslaskie;2020;2;69076;36770;32306;55671;5357;63719;22000;25934;43142
Kujawsko-pomorskie;2020;2;72133;42070;30063;58309;7847;64286;27700;34141;37992
Lubelskie;2020;2;75733;38665;37068;66162;13539;62194;31500;40734;34999
Lubuskie;2020;2;23529;13224;10305;18395;2321;21208;5900;9844;13685
Lodzkie;2020;2;67236;34544;32692;56604;5841;61395;25400;22272;44964
Malopolskie;2020;2;79677;43538;36139;65229;8952;70725;25300;42274;37403
Mazowieckie;2020;2;143052;72625;70427;117014;19729;123323;55100;65004;78048
Opolskie;2020;2;24999;13818;11181;20878;2221;22778;8000;11082;13917
Podkarpackie;2020;2;86159;45420;40739;71368;11612;74547;36000;53045;33114
Podlaskie;2020;2;37280;17515;19765;31418;5250;32030;15100;13705;23575
Pomorskie;2020;2;52341;31134;21207;42325;4878;47463;15300;22478;29863
Slaskie;2020;2;86784;47543;39241;70085;8102;78682;23000;20653;66131
Swietokrzyskie;2020;2;45778;23263;22515;38024;6195;39583;17400;25098;20680
Warminsko-mazurskie;2020;2;52928;29074;23854;41992;5816;47112;16700;26516;26412
Wielkopolskie;2020;2;59978;34428;25550;47289;5261;54717;14800;27825;32153
Zachodniopomorskie;2020;2;49788;27372;22416;40650;5307;44481;16400;20986;28802
Dolnoslaskie;2020;1;59500;31800;27700;49400;4700;54800;20400;23100;36400
Kujawsko-pomorskie;2020;1;65100;38500;26600;53700;7100;58000;26100;31400;33700
Lubelskie;2020;1;71400;36200;35200;63400;13100;58300;29700;39100;32300
Lubuskie;2020;1;19800;11500;8300;16000;2000;17800;5500;8800;11000
Lodzkie;2020;1;60600;31300;29300;51700;5300;55300;23800;20600;40000
Malopolskie;2020;1;66900;36800;30100;56400;7800;59100;23600;36300;30600
Mazowieckie;2020;1;127800;64800;63000;106500;18200;109500;51300;60000;67800
Opolskie;2020;1;21900;12200;9700;18800;2000;19900;7300;9800;12100
Podkarpackie;2020;1;78900;41500;37400;66500;10900;68100;33900;49200;29700
Podlaskie;2020;1;34000;15800;18200;29300;5000;29100;14300;12800;21200
Pomorskie;2020;1;45400;27700;17700;37400;4400;41000;13900;20200;25200
Slaskie;2020;1;71700;39600;32100;60300;7200;64500;21000;17500;54200
Swietokrzyskie;2020;1;43000;21900;21100;35800;5800;37200;16100;23900;19100
Warminsko-mazurskie;2020;1;48200;27100;21100;38900;5400;42800;15600;25000;23200
Wielkopolskie;2020;1;50600;29700;20900;41100;4700;45900;13200;23900;26700
Zachodniopomorskie;2020;1;44600;25300;19300;37100;4900;39700;15300;19700;24900
Dolnoslaskie;2019;4;56000;30700;25300;46300;4700;51300;20500;22200;33800
Kujawsko-pomorskie;2019;4;64100;38600;25500;52900;7500;56500;26500;31000;33100
Lubelskie;2019;4;69400;36000;33400;61500;13400;56000;29300;38300;31100
Lubuskie;2019;4;18500;10900;7600;14800;2000;16500;5500;8400;10100
Lodzkie;2019;4;58700;31200;27500;50000;5500;53200;23700;20100;38600
Malopolskie;2019;4;62600;35500;27100;52700;7800;54800;23600;33900;28700
Mazowieckie;2019;4;123200;63500;59700;102100;18300;104900;50800;58000;65200
Opolskie;2019;4;20900;12100;8800;18100;2100;18800;7200;9500;11400
Podkarpackie;2019;4;75500;40300;35200;63700;11100;64400;33500;47400;28100
Podlaskie;2019;4;33300;15800;17500;28600;5200;28100;14300;12900;20400
Pomorskie;2019;4;41800;26300;15500;34300;4400;37500;13500;18800;23000
Slaskie;2019;4;66500;37600;28900;55800;7100;59400;21200;16400;50100
Swietokrzyskie;2019;4;42000;22100;19900;35000;6200;35800;15900;24000;18000
Warminsko-mazurskie;2019;4;45700;26500;19200;36700;5500;40200;15600;24000;21700
Wielkopolskie;2019;4;46300;28000;18300;37200;4700;41700;12700;22200;24100
Zachodniopomorskie;2019;4;41800;24300;17500;34400;4800;37000;14900;19000;22800
Dolnoslaskie;2019;3;56100;31500;24600;46700;5000;51100;21200;22000;34100
Kujawsko-pomorskie;2019;3;62600;38800;23800;52100;7900;54600;27400;29700;32900
Lubelskie;2019;3;66000;35200;30800;59000;13400;52500;29700;35800;30200
Lubuskie;2019;3;18300;11000;7300;14800;2100;16200;6000;8200;10100
Lodzkie;2019;3;59100;32000;27100;50700;5800;53300;24700;19500;39600
Malopolskie;2019;3;61900;36300;25600;53000;8300;53600;24700;32900;29000
Mazowieckie;2019;3;123300;64900;58400;103100;19000;104300;52000;57200;66100
Opolskie;2019;3;20000;11800;8200;17300;2100;17900;7300;9000;11000
Podkarpackie;2019;3;72700;40300;32400;62000;11500;61200;33800;45100;27600
Podlaskie;2019;3;32800;16100;16700;28600;5400;27400;14600;12600;20200
Pomorskie;2019;3;41100;26100;15000;33900;4500;36500;13700;18100;23000
Slaskie;2019;3;67900;39700;28200;57500;7700;60200;23100;16200;51700
Swietokrzyskie;2019;3;40700;22200;18500;34200;6300;34400;15900;23000;17700
Warminsko-mazurskie;2019;3;43400;25800;17600;35500;5600;37900;16100;22500;20900
Wielkopolskie;2019;3;45100;28100;17000;36700;4900;40200;13000;21400;23700
Zachodniopomorskie;2019;3;40200;23600;16600;33500;4900;35300;15200;17800;22400
Dolnoslaskie;2019;2;57718;32114;25604;47991;4925;52793;22568;22492;35226
Kujawsko-pomorskie;2019;2;64660;39939;24721;53527;7920;56740;29215;30611;34049
Lubelskie;2019;2;68057;35678;32379;60868;13462;54595;31264;36889;31168
Lubuskie;2019;2;19507;11718;7789;15640;2135;17372;6763;8643;10864
Lodzkie;2019;2;61314;33051;28263;52098;5544;55770;26114;20131;41183
Malopolskie;2019;2;64076;37187;26889;54583;8063;56013;26995;33715;30361
Mazowieckie;2019;2;126653;66328;60325;105534;18716;107937;54596;58584;68069
Opolskie;2019;2;20166;11825;8341;17165;1952;18214;7635;8963;11203
Podkarpackie;2019;2;74684;40995;33689;63403;11283;63401;35626;46331;28353
Podlaskie;2019;2;33262;16055;17207;28958;5332;27930;15195;12576;20686
Pomorskie;2019;2;41845;26458;15387;34088;4346;37499;14444;18369;23476
Slaskie;2019;2;72409;42406;30003;60826;7796;64613;26478;17088;55321
Swietokrzyskie;2019;2;40556;21773;18783;33660;6009;34547;16097;22752;17804
Warminsko-mazurskie;2019;2;45114;26176;18938;36667;5531;39583;17655;23149;21965
Wielkopolskie;2019;2;46220;28524;17696;36888;4592;41628;14049;21637;24583
Zachodniopomorskie;2019;2;40852;23938;16914;33895;4873;35979;16136;18271;22581
Dolnoslaskie;2019;1;64700;35100;29600;54000;5500;59300;23400;25100;39600
Kujawsko-pomorskie;2019;1;72900;43800;29100;60500;8500;64400;31300;34800;38100
Lubelskie;2019;1;75100;38300;36800;67000;14600;60500;32200;40900;34200
Lubuskie;2019;1;22200;12900;9300;18000;2400;19800;7100;9800;12400
Lodzkie;2019;1;67700;35500;32200;57500;6000;61600;27300;22500;45200
Malopolskie;2019;1;72400;40700;31700;61700;9000;63400;28200;38800;33600
Mazowieckie;2019;1;138800;71200;67600;116200;20100;118700;57600;64700;74100
Opolskie;2019;1;22600;12900;9700;19200;2100;20500;8100;10200;12400
Podkarpackie;2019;1;83300;44600;38700;70400;12400;70900;37500;52000;31300
Podlaskie;2019;1;36900;17400;19500;32100;5700;31200;15900;13600;23300
Pomorskie;2019;1;47900;29700;18200;39200;4800;43200;14900;21300;26600
Slaskie;2019;1;82200;47200;35000;69700;8900;73400;28600;19400;62800
Swietokrzyskie;2019;1;44500;23000;21500;37000;6400;38200;16600;24900;19600
Warminsko-mazurskie;2019;1;53700;30200;23500;43600;6300;47400;19500;27800;25900
Wielkopolskie;2019;1;52500;31800;20700;42300;5000;47500;15400;24900;27600
Zachodniopomorskie;2019;1;47300;27200;20100;39200;5500;41800;17100;21200;26100
Dolnoslaskie;2018;4;62800;34933;27867;52470;5617;57225;23385;24521;38279
Kujawsko-pomorskie;2018;4;72700;44215;28485;60506;9113;63542;32041;34760;37940
Lubelskie;2018;4;74400;38632;35768;66690;15228;59221;32411;40756;33644
Lubuskie;2018;4;22200;13115;9085;18011;2592;19609;7197;9830;12370
Lodzkie;2018;4;66000;35220;30780;56069;6258;59778;26976;22074;43926
Malopolskie;2018;4;71500;41157;30343;60882;9492;61997;28531;38298;33202
Mazowieckie;2018;4;136500;71105;65395;114407;21042;115503;58124;63776;72724
Opolskie;2018;4;22700;13347;9353;19387;2342;20321;8236;10248;12452
Podkarpackie;2018;4;82900;45024;37876;70482;13062;69871;37663;52334;30566
Podlaskie;2018;4;36800;17524;19276;32033;6016;30770;15937;13826;22974
Pomorskie;2018;4;46100;29111;16989;37592;4915;41167;14577;20491;25609
Slaskie;2018;4;80100;46761;33339;68047;9428;70651;29220;18793;61307
Swietokrzyskie;2018;4;44100;23233;20867;36768;6839;37279;16195;24993;19107
Warminsko-mazurskie;2018;4;53100;30694;22406;43021;6674;46467;19795;27610;25490
Wielkopolskie;2018;4;50900;31452;19448;41073;5150;45717;15733;24383;26517
Zachodniopomorskie;2018;4;46000;27119;18881;38182;5690;40312;17280;21000;25000
Dolnoslaskie;2018;3;61800;34900;26900;52500;5800;56000;23400;23800;38000
Kujawsko-pomorskie;2018;3;70100;43600;26500;59400;9500;60600;32300;32800;37300
Lubelskie;2018;3;70800;37800;33000;64200;15300;55400;32200;38200;32600
Lubuskie;2018;3;21600;13100;8500;17800;2700;18900;7400;9600;12000
Lodzkie;2018;3;65600;35400;30200;56500;6600;59000;27300;21400;44200
Malopolskie;2018;3;70000;41100;28900;60600;10000;60000;28800;37000;33000
Mazowieckie;2018;3;136700;72400;64300;116000;22000;114800;59500;62300;74400
Opolskie;2018;3;21600;13000;8600;18700;2300;19300;8400;9600;12000
Podkarpackie;2018;3;79600;44600;35000;68800;13300;66300;37900;49300;30300
Podlaskie;2018;3;36100;17500;18600;31800;6200;29800;16100;13400;22700
Pomorskie;2018;3;44300;28300;16000;36600;4900;39400;14700;19400;24900
Slaskie;2018;3;80900;47800;33100;69600;9900;71000;30400;18400;62500
Swietokrzyskie;2018;3;42900;23200;19700;36400;7200;35700;15900;24100;18800
Warminsko-mazurskie;2018;3;50300;29600;20700;42000;6900;43400;20200;25800;24500
Wielkopolskie;2018;3;51200;32100;19100;42400;5600;45700;16800;24200;27000
Zachodniopomorskie;2018;3;44000;26200;17800;37100;5700;38300;17400;19700;24300
Dolnoslaskie;2018;2;62900;34900;28000;53000;5700;57200;24000;24000;38900
Kujawsko-pomorskie;2018;2;72500;44500;28000;61100;9500;63100;33800;33900;38600
Lubelskie;2018;2;72400;37800;34600;65500;15200;57100;33000;38900;33500
Lubuskie;2018;2;21900;13100;8800;17800;2600;19200;7600;9600;12300
Lodzkie;2018;2;67100;35700;31400;57400;6500;60600;28100;21700;45400
Malopolskie;2018;2;71100;41200;29900;61200;9700;61400;29500;37300;33800
Mazowieckie;2018;2;140100;73200;66900;118400;21600;118500;61800;63100;77000
Opolskie;2018;2;22100;13100;9000;19000;2200;19900;8900;9700;12400
Podkarpackie;2018;2;81600;45200;36400;70300;13000;68600;39100;50500;31100
Podlaskie;2018;2;36700;17500;19200;32200;6100;30600;16500;13600;23100
Pomorskie;2018;2;44400;27900;16500;36300;4800;39600;14900;19300;25100
Slaskie;2018;2;84100;48800;35300;71800;9900;74200;31900;18800;65300
Swietokrzyskie;2018;2;43100;22900;20200;36000;6900;36100;15900;23900;19200
Warminsko-mazurskie;2018;2;50900;29400;21500;42100;6700;44200;21100;25700;25200
Wielkopolskie;2018;2;52400;32500;19900;42900;5500;46900;17900;24800;27600
Zachodniopomorskie;2018;2;44700;26200;18500;37600;5600;39100;18400;19700;25000
Dolnoslaskie;2018;1;70600;37700;32900;59500;6200;64400;25400;26900;43700
Kujawsko-pomorskie;2018;1;81500;48200;33300;68500;9900;71700;36200;38800;42700
Lubelskie;2018;1;80700;40300;40400;72800;16300;64500;34900;44200;36500
Lubuskie;2018;1;24900;14300;10600;20500;2900;21900;8000;10800;14100
Lodzkie;2018;1;73800;37900;35900;63300;7000;66900;29700;24400;49400
Malopolskie;2018;1;80400;44500;35900;69000;10500;69900;31000;42600;37800
Mazowieckie;2018;1;154700;77900;76800;131500;23400;131300;66300;70200;84500
Opolskie;2018;1;25500;14300;11200;22000;2500;23000;9700;11400;14100
Podkarpackie;2018;1;91300;48600;42700;78600;14300;77000;41700;57100;34200
Podlaskie;2018;1;40500;18800;21700;35500;6700;33900;17700;15000;25500
Pomorskie;2018;1;50500;30700;19800;41400;5300;45200;15900;22300;28200
Slaskie;2018;1;95200;53600;41600;81900;11100;84100;34000;21800;73400
Swietokrzyskie;2018;1;48400;24700;23700;40600;7500;40900;16700;27000;21400
Warminsko-mazurskie;2018;1;60800;33500;27300;50100;7600;53300;23300;31200;29600
Wielkopolskie;2018;1;60500;36100;24400;50100;6100;54500;19700;29000;31500
Zachodniopomorskie;2018;1;52800;30100;22700;44200;6400;46300;19700;23500;29300
Dolnoslaskie;2017;4;68800;37300;31500;57800;6300;62500;25800;26300;42500
Kujawsko-pomorskie;2017;4;81500;48800;32700;68600;10500;71000;36900;38700;42800
Lubelskie;2017;4;81200;41500;39700;73600;17400;63800;35700;44400;36800
Lubuskie;2017;4;24600;14500;10100;20200;3000;21600;7800;10900;13700
Lodzkie;2017;4;72700;37600;35100;62400;7300;65400;30400;24100;48600
Malopolskie;2017;4;79400;44700;34700;68400;11100;68300;31400;42100;37300
Mazowieckie;2017;4;154100;78800;75300;130900;24400;129700;68300;69700;84400
Opolskie;2017;4;26100;15000;11100;22700;2700;23300;10100;12000;14100
Podkarpackie;2017;4;91000;48600;42400;78700;15100;75900;42000;57200;33800
Podlaskie;2017;4;40000;18900;21100;35100;7000;33000;18200;15000;25000
Pomorskie;2017;4;49700;30900;18800;40600;5600;44100;16200;22000;27700
Slaskie;2017;4;94700;54500;40200;81800;11700;83000;35000;21400;73300
Swietokrzyskie;2017;4;46600;24200;22400;39100;7600;39000;16500;26400;20200
Warminsko-mazurskie;2017;4;60000;33800;26200;49400;7700;52300;23800;30800;29200
Wielkopolskie;2017;4;58900;35800;23100;48800;6300;52500;20400;28300;30600
Zachodniopomorskie;2017;4;52600;30600;22000;44000;6700;45900;20000;23800;28800
Dolnoslaskie;2017;3;73100;40600;32500;61800;7100;66000;28000;27300;45800
Kujawsko-pomorskie;2017;3;82300;50400;31900;70100;11500;70900;38300;38300;44000
Lubelskie;2017;3;79600;41600;38000;72900;17700;61900;37400;42600;37000
Lubuskie;2017;3;25600;15100;10500;21100;3200;22400;8400;11200;14400
Lodzkie;2017;3;76600;40400;36200;66500;8100;68500;33100;24500;52100
Malopolskie;2017;3;81900;47100;34800;71100;12000;69800;33200;42500;39400
Mazowieckie;2017;3;162400;84500;77900;139400;26500;135900;74200;71400;91000
Opolskie;2017;3;26700;15600;11100;23400;2900;23800;11000;12100;14600
Podkarpackie;2017;3;90300;49700;40600;78900;15800;74500;43600;55700;34600
Podlaskie;2017;3;41700;20200;21500;37100;7500;34100;19700;15300;26400
Pomorskie;2017;3;51600;32400;19200;42500;6000;45600;17600;22500;29100
Slaskie;2017;3;100900;59000;41900;87200;12900;88000;38400;22100;78800
Swietokrzyskie;2017;3;46800;24800;22000;39800;8100;38700;17700;25900;20900
Warminsko-mazurskie;2017;3;60600;34600;26000;50600;8300;52300;25200;30300;30300
Wielkopolskie;2017;3;63200;38900;24300;53400;7300;55900;22400;30000;33200
Zachodniopomorskie;2017;3;53900;31500;22400;45700;7200;46700;21600;23400;30500
Dolnoslaskie;2017;2;75200;40800;34400;62900;6800;68300;29500;28100;47100
Kujawsko-pomorskie;2017;2;85800;51300;34500;72300;11600;74200;39600;39800;46000
Lubelskie;2017;2;82200;41700;40500;74900;17800;64400;39600;44100;38100
Lubuskie;2017;2;26600;15500;11100;21500;3100;23500;8900;11500;15100
Lodzkie;2017;2;79300;41000;38300;68100;7900;71400;35400;25200;54100
Malopolskie;2017;2;83400;46700;36700;71400;11600;71800;34700;43200;40200
Mazowieckie;2017;2;168300;85800;82500;144500;26800;141500;78400;73500;94800
Opolskie;2017;2;28000;15900;12100;24300;2900;25100;11600;12800;15200
Podkarpackie;2017;2;92000;49800;42200;80000;15500;76500;44800;56700;35300
Podlaskie;2017;2;42600;20000;22600;38000;7600;35000;20200;15600;27000
Pomorskie;2017;2;52200;32000;20200;42600;5800;46400;18500;22600;29600
Slaskie;2017;2;105000;59900;45100;89500;12700;92300;40600;22800;82200
Swietokrzyskie;2017;2;47900;24600;23300;40300;8000;40000;18900;26500;21400
Warminsko-mazurskie;2017;2;61500;34200;27300;50600;8200;53300;26100;30800;30700
Wielkopolskie;2017;2;65800;39600;26200;54700;7100;58700;23900;31100;34700
Zachodniopomorskie;2017;2;56000;31800;24200;47200;7300;48700;22600;24000;32000
Dolnoslaskie;2017;1;86200;45100;41100;72200;7700;78600;31300;32400;53800
Kujawsko-pomorskie;2017;1;98700;56500;42200;83000;12400;86300;41600;46600;52100
Lubelskie;2017;1;94900;46100;48800;86300;20200;74800;42900;51800;43100
Lubuskie;2017;1;31000;17300;13700;25300;3600;27400;9700;13500;17500
Lodzkie;2017;1;90600;45200;45400;77700;9000;81500;38200;29900;60700
Malopolskie;2017;1;95800;51200;44600;82400;13300;82500;37500;50200;45600
Mazowieckie;2017;1;187700;92500;95200;161700;28800;158900;84100;83100;104600
Opolskie;2017;1;32400;17600;14800;28100;3200;29200;12200;14800;17600
Podkarpackie;2017;1;105900;55200;50700;91900;17400;88500;48300;66000;39900
Podlaskie;2017;1;47800;21600;26200;42600;8400;39400;21600;17500;30300
Pomorskie;2017;1;61800;36400;25400;51000;6800;55000;20300;27200;34600
Slaskie;2017;1;119900;66000;53900;102900;14500;105300;44100;26600;93300
Swietokrzyskie;2017;1;55400;27600;27800;46700;8800;46600;20800;30700;24700
Warminsko-mazurskie;2017;1;73100;39000;34100;60000;9200;63900;28100;37400;35700
Wielkopolskie;2017;1;77600;45100;32500;65000;8000;69500;26400;37000;40600
Zachodniopomorskie;2017;1;65300;35700;29600;54600;8300;57100;24100;28300;37000
Dolnoslaskie;2016;4;86000;45500;40500;72500;8300;77700;31500;32400;53600
Kujawsko-pomorskie;2016;4;98500;56700;41800;83300;13400;85200;41300;46600;51900
Lubelskie;2016;4;95600;47200;48400;87600;21700;73900;43400;53000;42600
Lubuskie;2016;4;32400;18300;14100;26700;4100;28300;10700;14200;18200
Lodzkie;2016;4;91000;46100;44900;78800;9800;81300;39300;30400;60600
Malopolskie;2016;4;96500;52300;44200;84200;14400;82100;38500;50600;45900
Mazowieckie;2016;4;188900;93800;95100;163200;30700;158200;85700;84400;104500
Opolskie;2016;4;32400;18000;14400;28400;3500;28900;12100;15000;17400
Podkarpackie;2016;4;107600;56400;51200;94000;18600;89000;48600;67800;39800
Podlaskie;2016;4;48400;22100;26300;43100;8900;39500;22300;18000;30400
Pomorskie;2016;4;64100;38500;25600;53900;7500;56600;22900;28800;35300
Slaskie;2016;4;120000;66700;53300;103800;15600;104400;45500;26600;93400
Swietokrzyskie;2016;4;57100;28900;28200;48700;10000;47100;21500;32100;25000
Warminsko-mazurskie;2016;4;73100;39600;33500;60200;9700;63400;28400;37400;35700
Wielkopolskie;2016;4;77700;45700;32000;65300;8800;68900;27200;37500;40200
Zachodniopomorskie;2016;4;65800;36400;29400;54800;8600;57200;24000;29000;36800
Dolnoslaskie;2016;3;85700;46200;39500;72900;9000;76700;41800;31700;54000
Kujawsko-pomorskie;2016;3;95000;55900;39100;80900;13900;81100;87900;44300;50700
Lubelskie;2016;3;91100;46000;45100;84000;21700;69400;39500;49700;41400
Lubuskie;2016;3;31300;17700;13600;25800;4000;27200;46900;13500;17800
Lodzkie;2016;3;92600;47300;45300;80600;10400;82100;43400;30100;62500
Malopolskie;2016;3;96100;53200;42900;84500;15500;80600;50500;49500;46600
Mazowieckie;2016;3;193700;97400;96300;168100;33400;160300;23400;85100;108600
Opolskie;2016;3;31500;17900;13600;27800;3700;27800;22100;14400;17100
Podkarpackie;2016;3;105400;57000;48400;93600;20000;85400;10800;65200;40200
Podlaskie;2016;3;49000;22900;26100;44100;9700;39300;27800;17900;31100
Pomorskie;2016;3;63500;38500;25000;53700;7800;55700;24000;27800;35700
Slaskie;2016;3;122000;68600;53400;105600;16600;105400;32700;26700;95300
Swietokrzyskie;2016;3;56800;29600;27200;49100;10900;45900;11900;31800;25000
Warminsko-mazurskie;2016;3;69500;38400;31100;58300;10000;59500;40300;34800;34700
Wielkopolskie;2016;3;78200;46500;31700;66500;9500;68700;23200;37400;40800
Zachodniopomorskie;2016;3;63000;35300;27700;53000;8800;54200;28500;26700;36300
Dolnoslaskie;2016;2;90700;47400;43300;76400;9200;81500;33800;33400;57300
Kujawsko-pomorskie;2016;2;98900;57000;41900;83600;14100;84800;40900;46000;52900
Lubelskie;2016;2;95800;47300;48500;88100;22100;73700;44800;52100;43700
Lubuskie;2016;2;33400;18300;15100;27500;4300;29200;11300;14200;19200
Lodzkie;2016;2;99000;49400;49600;85500;10800;88100;43900;32000;67000
Malopolskie;2016;2;103400;56000;47400;90000;16000;87500;43400;53200;50200
Mazowieckie;2016;2;202000;99400;102600;174400;34200;167800;90400;88200;113800
Opolskie;2016;2;32800;18200;14600;28700;3600;29200;12100;15100;17700
Podkarpackie;2016;2;108000;56900;51100;95400;19600;88400;51900;66900;41100
Podlaskie;2016;2;50300;22900;27400;45100;9800;40500;23900;18100;32200
Pomorskie;2016;2;66900;39500;27400;55900;8000;58900;24800;29300;37600
Slaskie;2016;2;130700;71700;59000;112300;17200;113500;49900;28400;102300
Swietokrzyskie;2016;2;59600;29800;29800;51500;11200;48400;23100;33200;26400
Warminsko-mazurskie;2016;2;72300;38700;33600;60300;10200;62100;29600;36200;36100
Wielkopolskie;2016;2;81900;47900;34000;68500;9500;72500;29100;38400;43500
Zachodniopomorskie;2016;2;66700;36100;30600;55800;9200;57500;25400;27800;38900
Dolnoslaskie;2016;1;104000;52500;51500;87600;10400;93600;36100;38700;65300
Kujawsko-pomorskie;2016;1;111200;61300;49900;93500;14900;96300;43200;52100;59100
Lubelskie;2016;1;110300;52600;57700;100800;25200;85100;47900;60900;49400
Lubuskie;2016;1;39400;20900;18500;32600;5100;34400;12200;16600;22800
Lodzkie;2016;1;112900;55000;57900;97700;12600;100300;47100;37300;75600
Malopolskie;2016;1;122000;63700;58300;105800;19000;103000;48400;64700;57300
Mazowieckie;2016;1;221500;105800;115700;191700;37600;183900;96300;98000;123500
Opolskie;2016;1;36900;19600;17300;32000;4000;33000;12700;17100;19800
Podkarpackie;2016;1;125000;63700;61300;109800;22700;102300;55600;78500;46500
Podlaskie;2016;1;56200;24900;31300;50300;10900;45300;25000;20200;36000
Pomorskie;2016;1;79300;45100;34200;66500;9500;69900;27600;35500;43800
Slaskie;2016;1;151200;80500;70700;131000;20000;131200;56000;33500;117700
Swietokrzyskie;2016;1;67700;32600;35100;58300;12300;55400;25000;38100;29600
Warminsko-mazurskie;2016;1;85900;44100;41800;71200;11800;74000;32100;43400;42500
Wielkopolskie;2016;1;96700;54600;42100;81000;11000;85700;32000;46000;50700
Zachodniopomorskie;2016;1;80200;42300;37900;67100;11200;69000;28600;33800;46400
Dolnoslaskie;2015;4;99952;51579;48373;83957;10838;89114;35991;37369;62583
Kujawsko-pomorskie;2015;4;107255;60367;46888;90112;15648;91607;42768;50537;56718
Lubelskie;2015;4;107895;52567;55328;98765;26485;81410;47067;60189;47706
Lubuskie;2015;4;39348;21263;18085;32617;5363;33985;12242;16899;22449
Lodzkie;2015;4;109510;54504;55006;95001;13435;96075;46019;36289;73221
Malopolskie;2015;4;119601;64189;55412;104177;20133;99468;48127;63797;55804
Mazowieckie;2015;4;216527;104684;111843;187009;38674;177853;96044;95480;121047
Opolskie;2015;4;36203;19766;16437;31421;4231;31972;12459;16857;19346
Podkarpackie;2015;4;123514;63579;59935;109097;24411;99103;54756;78005;45509
Podlaskie;2015;4;55019;24943;30076;49300;11339;43680;24449;20055;34964
Pomorskie;2015;4;77662;44573;33089;64930;9769;67893;27795;35139;42523
Slaskie;2015;4;148508;80665;67843;128849;21236;127272;55825;32634;115874
Swietokrzyskie;2015;4;66131;32687;33444;57157;13112;53019;24692;37138;28993
Warminsko-mazurskie;2015;4;83510;44083;39427;68858;12179;71331;31597;42491;41019
Wielkopolskie;2015;4;93311;53807;39504;78156;11745;81566;31722;44862;48449
Zachodniopomorskie;2015;4;79393;42882;36511;66618;11547;67846;29302;33853;45540
Dolnoslaskie;2015;3;98800;51700;47100;83000;11200;87700;37300;35800;63000
Kujawsko-pomorskie;2015;3;104400;60400;44000;88600;16400;88000;43700;48400;56000
Lubelskie;2015;3;101000;50300;50700;93000;25500;75500;46900;55300;45700
Lubuskie;2015;3;38600;21100;17500;32200;5500;33100;13200;16300;22300
Lodzkie;2015;3;109300;54900;54400;95100;13500;95800;47400;34900;74400
Malopolskie;2015;3;117300;64000;53300;103100;20700;96500;49500;61800;55500
Mazowieckie;2015;3;220900;108600;112300;191700;40600;180300;99000;95000;125900
Opolskie;2015;3;34300;19000;15300;29700;4300;30000;12500;15900;18400
Podkarpackie;2015;3;118300;62500;55800;105200;24400;93800;54600;73500;44800
Podlaskie;2015;3;53800;25100;28700;48500;11600;42200;24500;19300;34500
Pomorskie;2015;3;77200;44800;32400;65000;10100;67100;29400;34100;43100
Slaskie;2015;3;149200;81600;67600;129700;21900;127300;58500;32100;117100
Swietokrzyskie;2015;3;63900;32400;31500;55600;13100;50800;25800;35700;28200
Warminsko-mazurskie;2015;3;81400;43600;37800;68300;12600;68800;32200;40500;40900
Wielkopolskie;2015;3;94500;55500;39000;80100;12500;82000;33800;44900;49600
Zachodniopomorskie;2015;3;76600;41500;35100;64900;11600;65000;29900;31200;45400
Dolnoslaskie;2015;2;106800;54700;52100;89100;11600;95200;40900;38400;68400
Kujawsko-pomorskie;2015;2;109900;62100;47800;92900;16800;93100;46900;50600;59300
Lubelskie;2015;2;104500;50700;53800;95600;25700;78800;49100;57000;47500
Lubuskie;2015;2;41500;22500;19000;34400;5800;35700;14400;17200;24300
Lodzkie;2015;2;117900;58100;59800;101800;14300;103600;51800;37500;80400
Malopolskie;2015;2;122600;64900;57700;106500;20700;101900;52000;64000;58600
Mazowieckie;2015;2;227700;109800;117900;196400;41000;186700;103300;97100;130600
Opolskie;2015;2;37200;20000;17200;31900;4100;33100;14000;17000;20200
Podkarpackie;2015;2;120600;62100;58500;106300;23600;96900;56600;74800;45800
Podlaskie;2015;2;55500;25300;30200;49600;11600;43900;25500;19500;36000
Pomorskie;2015;2;82400;46600;35800;69200;10600;71800;32300;35800;46600
Slaskie;2015;2;159600;85400;74200;137400;22600;137000;63400;34200;125400
Swietokrzyskie;2015;2;68500;33900;34600;59300;13600;54900;28300;38100;30400
Warminsko-mazurskie;2015;2;84200;44100;40100;70300;12800;71400;34100;41500;42700
Wielkopolskie;2015;2;101900;58700;43200;85400;12800;89100;37500;47600;54300
Zachodniopomorskie;2015;2;81400;42900;38500;69000;12200;69300;32200;32800;48600
Dolnoslaskie;2015;1;124700;62600;62100;105100;14100;110700;46700;45500;79200
Kujawsko-pomorskie;2015;1;127900;69500;58400;108500;19000;108900;52900;59500;68400
Lubelskie;2015;1;119900;56500;63400;109500;29900;90000;54100;66900;53000
Lubuskie;2015;1;47500;24800;22700;39700;6800;40700;15800;19800;27700
Lodzkie;2015;1;131100;63300;67800;113300;16400;114600;55900;43500;87600
Malopolskie;2015;1;142200;72800;69400;123400;24800;117400;57400;76700;65500
Mazowieckie;2015;1;252100;118500;133600;217900;46200;205900;112400;109000;143100
Opolskie;2015;1;42900;22000;20900;36800;5000;37900;15600;20100;22800
Podkarpackie;2015;1;139900;70200;69700;123000;28300;111600;62400;87800;52100
Podlaskie;2015;1;62200;27900;34300;55600;13000;49200;28000;22100;40100
Pomorskie;2015;1;98000;53800;44200;83000;12900;85100;37500;43700;54300
Slaskie;2015;1;180600;94500;86100;156400;26500;154200;69000;39500;141100
Swietokrzyskie;2015;1;78200;37100;41100;67700;15500;62700;31600;43900;34300
Warminsko-mazurskie;2015;1;98400;49800;48600;81800;14900;83500;37600;49500;48900
Wielkopolskie;2015;1;119400;66000;53400;100800;15000;104400;42700;56500;62900
Zachodniopomorskie;2015;1;95600;49400;46200;81100;14500;81100;34900;39200;56400
